1111111111111111111111111111111111111111111111111111111111
10X0000X00X0000C00000C0X00000000010X0000000X0000C00000C001
10100101001000001010010000000101010100101001000001X1001001
10100100101010100010010000000101010100100101010100010010X1
100000X00C00C000000000X0000000X0C100000X00C00C000000000C01
1000000C00000000000000E0000000000X0X000000000000000X000011
1000000X0000X000000000000000000001000000000000000000000001
10X0000000X0000C00000C0X00000000010X0000000X0000C00000C001
1010010100100000101001000000010101010010100100000101001001
1010010010101010001001000000010101010010010101010001001001
100000X00C00C000000000X0000000X1C1P0000X00C00C0000X0000C01
1111111111111111111111111111111111111111111111111111111111
