111111111
1P0000001
111011101
1C00X0E11
111111111
