1111111111111111111111111111111111
1EX0000000X0000C00000C0X0000000001
1010010100100000101001000000010101
1010010010101010001001000000010101
1P0000X00C00C000000000X0000000X0C1
1111111111111111111111111111111111