1111111111111
1XX1XXXXXXX01
1XXXX11111XX1
1XXX11ECP1XX1
1111111111111