111111111
1P0000C01
100C000C1
1C000XE11
111111111
