111111111111111111
1C010000000C0000C1
100001111100X00001
1P0011E00C00011011
100C010000001XX1X1
111111111111111111