111111
1PXXX1
1CXCX1
1EXXX1
111111
