1111111111111
1P000000000E1
1C0C0C0C0C0C1
100000000X001
1111111111111
