111111111
1P000X0E1
1111111C1
111111111
