1111111111111
10010000C0001
1000011111001
1PP01100E0001
1111111111111