1111111111111
1C010000000C1
11100111110C1
1P0011E000001
1111111111111