1111111111111
1001000C00001
1000011111001
1P001100E0E01
1111111111111