1111111111111111111111111111111111
1E00000000X0000C00000C0X00000000X1
1010010100100000101001000000010101
1010010010101010001001000000010101
1P0000X00C00C000000000X0000000X0C1
1000000000000000000000000000000001
1111111111111111111111111111111111