1111111111111111111111111111111111111111111111111111111111111111111111111111111111111111111111111111
1000000000000000000011111111111111111111111111111111111111111111111111111111111111110000000000000001
1011111111111111111011111111111111111111111111111111111111111111111111111111111111110111111111111101
1010000000P00000000011111111111111111111111111111111111111111111111111111111111111110000000000000101
1010111111111111111111111111111111111111111111111111111111111111111111111111111111111111111111100101
1010100000000000000000000000000000000000000000000000000000000000000000000000000000000000000000100101
1010111111111111111111111111111111111111111111111111111111111111111111111111111111111111111100100101
1010000000000000000000000000000000000000000000000000000000000000000000000000000000000000000100100101
1011111111111111111111111111111111111111111111111111111111111111111111111111111111111111100100100101
1000000000000000000000000000000000000000000000000000000000000000000000000000000000000000100100100101
1111111111111111111111111111111111111111111111111111111111111111111111111111111111111100100100100101
1000000000000000000000000000000000000000000000000000000000000000000000000000000000000100100100100101
1011111111111111111111111111111111111111111111111111111111111111111111111111111111100100100100100101
1010000000000000000000000000000000000000000000000000000000000000000000000000000000100100100100100101
1010111111111111111111111111111111111111111111111111111111111111111111111111111100100100100100100101
1010100000000000000000000000000000000000000000000000000000000000000000000000000100100100100100100101
1010101111111111111111111111111111111111111111111111111111111111111111111111100100100100100100100101
1010100000000000000000000000000000000000000000000000000000000000000000000000100100100100100100100101
1010111111111111111111111111111111111111111111111111111111111111111111111110100100100100100100100101
1010000000000000000000000000000000000000000000000000000000000000000000000000100100100100100100100101
1011111111111111111111111111111111111111111111111111111111111111111111111111100100100100100100100101
1000000000000000000000000000000000000000000000000000000000000000000000000000000100100100100100100101
1011111111111111111111111111111111111111111111111111111111111111111111111111111100100100100100100101
1010000000000000000000000000000000000000000000000000000000000000000000000000000100100100100100100101
1010111111111111111111111111111111111111111111111111111111111111111111111111100100100100100100100101
1010100000000000000000000000000000000000000000000000000000000000000000000000100100100100100100100101
1010101111111111111111111111111111111111111111111111111111111111111111111110100100100100100100100101
1010100000000000000000000000000000000000000000000000000000000000000000000000100100100100100100100101
10101111111111111111111111111111111111111111111111111111111111111111111111111001001001E0100100100101
101000C000000000000000000000000000000000000000000000000000000000000000000000000100100100100100100101
1011111111111111111111111111111111111111111111111111111111111111111111111111111100100100100100100101
1010000000000000000000000000000000000000000000000000000000000000000000000000000100100100100100100101
1010111111111111111111111111111111111111111111111111111111111111111111111111100100100100100100100101
1010100000000000000000000000000000000000000000000000000000000000000000000000100100100100100100100101
1010101111111111111111111111111111111111111111111111111111111111111111111110100100100100100100100101
1010100000000000000000000000000000000000000000000000000000000000000000000000100100100100100100100101
1010111111111111111111111111111111111111111111111111111111111111111111111111100100100100100100100101
1010000000000000000000000000000000000000000000000000000000000000000000000000000100100100100100100101
1011111111111111111111111111111111111111111111111111111111111111111111111111111100100100100100100101
1000000000000000000000000000000000000000000000000000000000000000000000000000000000000000000000000001
1011111111111111111111111111111111111111111111111111111111111111111111111111111111111111111111111101
1010000000000000000000000000000000000000000000000000000000000000000000000000000000000000000000000101
1010111111111111111111111111111111111111111111111111111111111111111111111111111111111111111111100101
1010100000000000000000000000000000000000000000000000000000000000000000000000000000000000000000100101
1010101111111111111111111111111111111111111111111111111111111111111111111111111111111111111110100101
1010100000000000000000000000000000000000000000000000000000000000000000000000000000000000000100100101
1010111111111111111111111111111111111111111111111111111111111111111111111111111111111111100100100101
1010000000000000000000000000000000000000000000000000000000000000000000000000000000000000100100100101
1011111111111111111111111111111111111111111111111111111111111111111111111111111111111111100100100101
1000000000000000000000000000000000000000000000000000000000000000000000000000000000000000100100100101
1111111111111111111111111111111111111111111111111111111111111111111111111111111111111110100100100101
1000000000000000000000000000000000000000000000000000000000000000000000000000000000000100100100100101
1011111111111111111111111111111111111111111111111111111111111111111111111111111111100100100100100101
1010000000000000000000000000000000000000000000000000000000000000000000000000000000100100100100100101
1010111111111111111111111111111111111111111111111111111111111111111111111111111100100100100100100101
1010100000000000000000000000000000000000000000000000000000000000000000000000000100100100100100100101
1010101111111111111111111111111111111111111111111111111111111111111111111111110100100100100100100101
1010100000000000000000000000000000000000000000000000000000000000000000000000000100100100100100100101
1010111111111111111111111111111111111111111111111111111111111111111111111111100100100100100100100101
1010000000000000000000000000000000000000000000000000000000000000000000000000000100100100100100100101
1011111111111111111111111111111111111111111111111111111111111111111111111111111100100100100100100101
1000000000000000000000000000000000000000000000000000000000000000000000000000000000000000000000000001
1111111111111111111111111111111111111111111111111111111111111111111111111111111111111111111111111111