111111111
1P0000001
111011101
1C0000E11
111111111
