1111111111111
1P000000000E1
1C0C0C0C0C0C1
1000000000001
1111111111111
