111111111
1P00000E1
1111111C1
111111111
