111111111
1P0000C01
100C000C1
1C0000E11
111111111
